11111111111
1000000P001
1C0C0C11111
100000000E1
11100000011
1C000001111
11111111111