111111111111111
100C000P0000C01
1C0C0C111110001
100000000E11101
111000000110C01
1C0000011000111
1111000000C0001
111111111111111