111111111111111
10010C010000101
1P0000000000001
100000C00000C01
100001000100001
100010000000011
100001C1010C001
100000000000001
1CC000000C00111
10C0000001100C1
100010010C00001
1E0001000000011
100011000000101
11000000001C001
1000100C0000011
100000000010001
1010000C0000001
100000000100C01
100000010000011
111111111111111