111111111111111
1000100C1C000C1
100P10010001001
110101000C0CC01
11000000100E001
10C000000C00011
100010000000101
111000101000CC1
110110001000001
111111111111111