111111111111
100000C00011
1000P0100001
100C00000C01
111111111111