11E1C1P1
10000001
1C000001
10001001
10001001
1111110E