1111111111
1E00000C11
10000P0001
1000000001
1111111111